1111111111111
10010C0000001
1000011111001
1P0011E000C01
1111111111111